###+###
#.....#
#.....#
#.....#
#.....#
#.....#
###+###

#+#
#.#
#.###
#...+
#####


