###+###
#.....#
#.....#
+.....+
#.....#
#.....#
###+###

#?#~
#.#~
#.##
#..?
####

~~#?#~~
~~#.#~~
###.###
?.....?
#######

#+###
#.#.#
#...+
#...#
##+##

####
?..?
####

###+###
##...##
#.....#
+..#..+
#.....#
##...##
###+###

