###+###
#.....#
#.....#
+.....+
#.....#
#.....#
###+###

#?#~
#.#~
#.##
#..?
####

~~#?#~~
~~#.#~~
###.###
?.....?
#######

#+######
#.#....#
#......+
#......#
#......#
##+#####

#######
?.....?
#######

###+###
##...##
#.....#
+..#..+
#.....#
##...##
###+###

####+####
#.......#
#.......#
#...#...#
#..###..+
#...#...#
#.......#
#.......#
####+####

######+###
#........#
#..#..#..#
#........+
#..#..#..#
#........#
###+######


